10 34
#################################
#                     ^^#^^^    #
#     P               ^^#^^^    #
#              *      ^^^^^^   $#
#                     ^^^^^^   $#
#                     ^^^^^^   $#
#                     ^^#^^^    #
#                     ^^#^^^    #
#                     ^^#^^^    #
#################################