10 34
#################################
#                          ~    #
#    ### P    ###          ~    #
#    #          #          ~ ^^^#
#          L *             ~   ^#
#                          ~   ^#
#    #          #          ~ ^^^#
#    ###      ###          ~    #
#                          ~    #
#################################