10 34
#################################
#    #*#     #*#     #*#        #
#                               #
#    P                          #
#           #WWWW#              #
#           ######              #
#                               #
#                               #
#                               #
#################################